10 17
0 0
2 2 2 2 2 2 2 2 2 2
1 1 1 1 1 1 1 1 1 1
1 1 1 1 1 1 1 1 1 1
1 1 1 1 1 4 1 1 1 1
1 1 1 1 1 1 1 1 1 1
1 3 1 1 1 1 1 1 1 1
1 1 1 1 1 1 3 1 1 1
4 4 4 4 4 4 4 4 4 4
1 1 1 1 1 1 1 1 1 1
1 1 1 1 1 1 1 1 1 1
1 1 1 1 1 1 1 1 1 1
1 1 1 1 3 1 1 1 1 1
1 1 1 1 1 4 1 1 1 1
1 1 1 1 1 1 1 1 1 1
1 3 1 1 1 1 1 3 4 1
1 1 1 1 1 1 1 1 1 1
1 1 1 1 1 1 1 1 1 1